XXXXXXXXXX
----------
--X-------
----------
-----E----
----------
-----PX---
----------
----------
XXXXXXXXXX
