111111111111111
100000010000001
101011010110101
100P00010000001
101010111010101
101010010000001
101011010110111
111010000010111
100000000010E01
101010000010111
111010111110111
100000110000001
101110110101101
100100010001001
110001110101011
100100010000001
101110110111101
101010000000001
111111111111111
